############
#.........M#
#..........#
#..........#
#..........#
#..........#
#..........#
#..........#
#..........#
#@.........#
############