##########
#..#s#B..#
#..#.#..##
##.......#
#........#
###....###
#@.......#
##########