#################################################
#....s...#B#..........................#.........#
#........#......##..........##........#.........#
#........#......##..........##........#.........#
#........#............................#.........#
#........#............................#.........#
#........#......##..........##........#.........#
#........#......##s........k##........#.........#
#........#s.................##.......k#.........#
#@.............................................M#
#........#s.................##.......k#.........#
#........#......##s........k##........#.........#
#........#......##..........##........#.........#
#........#............................#.........#
#........#............................#.........#
#........#......##..........##........#.........#
#........#......##..........##........#.........#
#....s...#B#..........................#.........#
#################################################